7
HANDGUN 3 1 False
HUNG 3 1 True
DANG 0 4 False
NANG 2 4 True
HANG 0 6 False
HAND 0 6 True
DUNG 0 9 False
10 10
- - - - D - H A N D
- - - - A - A - - U
- - - - N A N G - N
- H U N G - G - - G
- A - - - - - - - -
- N - - - - - - - -
- D - - - - - - - -
- G - - - - - - - -
- U - - - - - - - -
- N - - - - - - - -
