7
REFEREE 0 5 False
REFER 6 2 True
FREER 1 3 True
FREE 3 2 True
REEF 6 2 False
REE 8 0 True
ERR 0 7 False
10 10
- - - - - R - E - -
- - - F R E E R - -
- - - - - F - R - -
- - F R E E - - - -
- - - - - R - - - -
- - - - - E - - - -
- - R E F E R - - -
- - E - - - - - - -
R E E - - - - - - -
- - F - - - - - - -
4
FER
ERE
REF
FEE
